Big Multiple Players Battlefield
MaxSteps=500
NumShells=20
Rows= 15
Cols= 33
#################################
#               #               #
#               #    8    8     #
# 1     1     1 #               #
#               #               #
#               #   7           #
#               #               #
#    3          #               #
#          4    #               #
# 2             #    6          #
#               #               #
#               #               #
#       5       #   9    9      #
#               #               #
#################################
