Tactical Maze Field
MaxSteps=100
NumShells=20
Rows=12
Cols=20
####################
#  1      #        #
#   ####     ###   #
#        #         #
#   ##       ##    #
#        @         #
#    ###      ###  #
#        #         #
#   ###       ###  #
#         #       2#
#   ####     ####  #
####################
