Big Multiple Players Battlefield
MaxSteps=500
NumShells=20
Rows= 15
Cols= 33
#################################
# 1  1          #               #
#          1    #  8   8        #
#               #               #
#   3           #               #
#               #   7           #
#               #               #
#               #               #
#          4    #               #
# 2             #    6          #
#               #               #
#               #               #
#      5        #    9    9     #
#               #               #
#################################
